s  ████████████████████████████
   ███   █  █        █  █     █
█  ████  █  ███████  ████  █  █
█     █              █  █     █
████  ████  ██████████  █  █  █
█     █        █  █  █     █  █
█  ████  ████  █  █  ████  ████
█        █                 █  █
█  ████  ████  █  █  ███████  █
█  █     █     █  █           █
███████  █  █  ████  ███████  █
█     █  █  █     █  █     █  █
█  ████  █  ████  ███████  █  █
█     █  █     █  █        █  █
█  ███████  ████  █  █  ████  █
█  █  █        █  █  █        █
█  █  ████████████████  ████  █
█              █  █  █  █     █
████  █  ███████  █  █  ████  █
█     █                    █  
████████████████████████████  e